Sunrise
An Interactive Fiction by AshTomWin
Release 1 / Serial number 130311 / Inform 7 build 6G60 (I6/v6.32 lib 6/12N) SD

Room 3539

>s
Hallway 1

>w
Stairwell Room

>e
Hallway 1

>s
Room 3540

>n
Hallway 1

>w
Stairwell Room

>w
You can't go that way.

>s
You can't go that way.

>e
Hallway 1

>e
Hallway 2

>e
Hallway 3

>e
Hallway 4

>e
Hallway 5

>e
You can't go that way.

>w
Hallway 4

>s
Room 3544

>n
Hallway 4

>n
Room 3545 <Your Room>

>s
Hallway 4

>l
Hallway 4

>look
Hallway 4

>look around
You can't see any such thing.

>e
Hallway 5

>n
Room 3547

>s
Hallway 5

>s
Room 3546

>n
Hallway 5

>w
Hallway 4

>w
Hallway 3

>n
Room 3543

>s
Hallway 3

>s
Hall Bathroom

>s
You can't go that way.

>n
Hallway 3

>w
Hallway 2

>n
Room 3541

>s
Hallway 2

>s
Room 3542

>n
Hallway 2

>w
Hallway 1

>n
Room 3539

>s
Hallway 1

>s
Room 3540

>s
You can't go that way.

>n
Hallway 1

>n
Room 3539

>w
Bathroom of 3539

>w
You can't go that way.

>e
Room 3539